111111111111111
10V00010000C001
100C0000PV10001
111111010011111
1E00000C0V11111
111111111111111